ğŸ“Œ 1. String á€™á€»á€¬á€¸á€¡á€á€½á€€á€º Function á€™á€»á€¬á€¸
Function	á€›á€Šá€ºá€›á€½á€šá€ºá€á€»á€€á€º (á€™á€¼á€”á€ºá€™á€¬)	á€¥á€•á€™á€¬
toUpperCase()	á€…á€¬á€œá€¯á€¶á€¸á€¡á€¬á€¸á€œá€¯á€¶á€¸á€€á€­á€¯ á€—á€»á€Šá€ºá€¸á€€á€¼á€®á€¸á€¡á€–á€¼á€…á€ºá€•á€¼á€±á€¬á€„á€ºá€¸	'aung'.toUpperCase() â†’ 'AUNG'
toLowerCase()	á€…á€¬á€œá€¯á€¶á€¸á€¡á€¬á€¸á€œá€¯á€¶á€¸á€€á€­á€¯ á€—á€»á€Šá€ºá€¸á€á€±á€¸á€¡á€–á€¼á€…á€ºá€•á€¼á€±á€¬á€„á€ºá€¸	'AUNG'.toLowerCase() â†’ 'aung'
includes()	á€…á€¬á€€á€¼á€±á€¬á€„á€ºá€¸á€‘á€²á€™á€¾á€¬ string á€á€…á€ºá€á€¯á€•á€«/á€™á€•á€« á€…á€…á€º	'hello'.includes('e') â†’ true
replace()	á€…á€¬á€á€¬á€¸á€á€…á€ºá€á€¯á€€á€­á€¯ á€¡á€á€¼á€¬á€¸á€á€…á€ºá€á€¯á€”á€²á€·á€¡á€…á€¬á€¸á€‘á€­á€¯á€¸	'hello'.replace('h', 'y') â†’ 'yello'
slice()	á€…á€¬á€œá€¯á€¶á€¸á€á€…á€ºá€…á€­á€á€ºá€á€…á€ºá€•á€­á€¯á€„á€ºá€¸ á€á€¼á€¬á€¸á€‘á€¯á€á€º	'hello'.slice(1, 4) â†’ 'ell'
ğŸ“Œ 2. Array á€™á€»á€¬á€¸á€¡á€á€½á€€á€º Function á€™á€»á€¬á€¸
Function	á€›á€Šá€ºá€›á€½á€šá€ºá€á€»á€€á€º	á€¥á€•á€™á€¬
push()	Array á€‘á€²á€¡á€†á€¯á€¶á€¸á€™á€¾á€¬ item á€‘á€Šá€·á€º	arr.push(5)
pop()	Array á€¡á€†á€¯á€¶á€¸á€€ item á€–á€»á€€á€º	arr.pop()
shift()	Array á€¡á€¡á€…á€€ item á€–á€»á€€á€º	arr.shift()
unshift()	Array á€¡á€…á€™á€¾á€¬ item á€‘á€Šá€·á€º	arr.unshift(1)
map()	Array á€‘á€² item á€á€…á€ºá€á€¯á€á€»á€„á€ºá€¸á€€á€­á€¯ á€•á€¼á€±á€¬á€„á€ºá€¸	arr.map(x => x * 2)
filter()	condition á€á€…á€ºá€á€¯á€¡á€•á€±á€«á€ºá€™á€°á€á€Šá€ºá€•á€¼á€®á€¸ item á€›á€½á€±á€¸	arr.filter(x => x > 5)
reduce()	Array á€€á€­á€¯ á€á€…á€ºá€á€¯á€á€Šá€ºá€¸á€á€±á€¬á€á€”á€ºá€–á€­á€¯á€¸á€¡á€–á€¼á€…á€ºá€á€»á€¯á€•á€º	arr.reduce((a, b) => a + b, 0)
find()	condition á€€á€­á€¯á€œá€€á€ºá€á€¶á€á€²á€· á€•á€‘á€™ item á€€á€­á€¯ return	arr.find(x => x > 3)
includes()	Array á€‘á€²á€™á€¾á€¬ á€á€”á€ºá€–á€­á€¯á€¸á€á€…á€ºá€á€¯á€•á€«/á€™á€•á€« á€…á€…á€º	[1,2,3].includes(2) â†’ true
ğŸ“Œ 3. Number á€™á€»á€¬á€¸á€¡á€á€½á€€á€º Function á€™á€»á€¬á€¸
Function	á€›á€Šá€ºá€›á€½á€šá€ºá€á€»á€€á€º	á€¥á€•á€™á€¬
toFixed()	á€á€á€ºá€™á€¾á€á€ºá€‘á€¬á€¸á€á€²á€· á€’á€¿á€™á€”á€²á€·á€•á€¼	(12.345).toFixed(2) â†’ '12.35'
parseInt()	string á€€á€­á€¯ integer á€•á€¼á€±á€¬á€„á€ºá€¸	parseInt('123') â†’ 123
parseFloat()	string á€€á€­á€¯ float á€•á€¼á€±á€¬á€„á€ºá€¸	parseFloat('12.34') â†’ 12.34
isNaN()	NaN á€–á€¼á€…á€º/á€™á€–á€¼á€…á€º á€…á€…á€º	isNaN('abc') â†’ true
ğŸ“Œ 4. Math Function á€™á€»á€¬á€¸ (Global Math Object)
Function	á€›á€Šá€ºá€›á€½á€šá€ºá€á€»á€€á€º	á€¥á€•á€™á€¬
Math.round()	á€¡á€”á€®á€¸á€†á€¯á€¶á€¸á€œá€¯á€¶á€¸á€•á€¼á€á€º	Math.round(4.6) â†’ 5
Math.floor()	á€¡á€±á€¬á€€á€ºá€†á€¯á€¶á€¸á€œá€¯á€¶á€¸á€•á€¼á€á€º	Math.floor(4.9) â†’ 4
Math.ceil()	á€¡á€•á€±á€«á€ºá€†á€¯á€¶á€¸á€œá€¯á€¶á€¸á€•á€¼á€á€º	Math.ceil(4.1) â†’ 5
Math.random()	0 á€”á€²á€· 1 á€¡á€€á€¼á€¬á€¸á€€ random number	Math.random()
Math.max()	á€¡á€€á€¼á€®á€¸á€†á€¯á€¶á€¸á€€á€­á€¯ á€›á€½á€±á€¸	Math.max(1, 5, 3) â†’ 5
Math.min()	á€¡á€„á€šá€ºá€†á€¯á€¶á€¸á€€á€­á€¯ á€›á€½á€±á€¸	Math.min(1, 5, 3) â†’ 1
ğŸ“Œ 5. Date Function á€™á€»á€¬á€¸ (Date Class)
Function	á€›á€Šá€ºá€›á€½á€šá€ºá€á€»á€€á€º	á€¥á€•á€™á€¬
new Date()	á€šá€”á€±á€·á€›á€€á€ºá€…á€½á€² object á€–á€”á€ºá€á€®á€¸	new Date()
getFullYear()	á€”á€¾á€…á€ºá€€á€­á€¯ á€šá€°	date.getFullYear()
getMonth()	á€œ (0-based) á€šá€°	date.getMonth()
getDate()	á€›á€€á€º (day of month) á€šá€°	date.getDate()
toISOString()	ISO format string	date.toISOString()
ğŸ“Œ 6. JSON Function á€™á€»á€¬á€¸
Function	á€›á€Šá€ºá€›á€½á€šá€ºá€á€»á€€á€º	á€¥á€•á€™á€¬
JSON.stringify()	object â†’ JSON string	JSON.stringify({a:1}) â†’ '{"a":1}'
JSON.parse()	JSON string â†’ object	JSON.parse('{"a":1}') â†’ {a:1}
ğŸ“Œ 7. Other Useful Global Functions
Function	á€›á€Šá€ºá€›á€½á€šá€ºá€á€»á€€á€º	á€¥á€•á€™á€¬
setTimeout()	á€¡á€á€»á€­á€”á€ºá€€á€¼á€¬á€•á€¼á€®á€¸ callback run	setTimeout(() => {}, 1000)
setInterval()	á€€á€¼á€¬á€á€»á€­á€”á€ºá€á€­á€¯á€„á€ºá€¸ callback run	setInterval(() => {}, 1000)
alert()	message á€á€…á€ºá€á€¯á€•á€¼	alert('Hello')
console.log()	Console á€‘á€²á€•á€¼	console.log("Hello")